tho	though
u	you
ur	you are
its	it is
&	and
y'all	you all
youre	you are
og's	old generations
you'd	you would
nah	no
ppl	people
you'll	you will
dnt	do not
txt	text
giv	give
fck	fuck
abt	about
pics	pictures
yall	you all
arent	are not
ive	i have
uo	you
gotts	gotta
id	i would
bustin	busting
em	them
noo	no
yess	yes
alot	a lot
outta	out of
fic	fiction
yay	i am so happy
b4	before
b	be
they'd	they would
bf	boy friend
c	see
luv	love
congrats	congratulations
feb	february
jan	january
yeah	yes
abit	a bit
n	and
nolimit	no limit
that'll	that will
yea	yeah
no1	no one
tryna	trying to
cuz	because
againn	again
fr	for
r	are
d	the
hasnt	has not
theyll	they will
youll	you will
ull	you will
hes	he is
shes	she is
cheatin	cheating
doin	doing
goin	going
readin	reading
writin	writing
2when	to when
ovr	over
woah	wow
woh	wow
dearr	dear
gon	gone
doesnt	does not
hasnt	has not
finee	fine
soo	so
ya	you
wrestlemani	wrestleania
hai	hi
'em	them
em	them
grp	group
thru	through
tryna	trying to
rly	really
buut	but
im	I am
idc	I dont care
&	and
myt	might
mooking	booking
w/	with
y	why
imean	i mean
ur	you are
todaay	today
somethin	something
hoee	hoe
pic	picture
goo	go
ima	i am going to
twas	it was
besst	best
til	till
cuz	because
tho	though
prolly	probably
tbh	to be honest
zt	that
prrtend	pretend
jus	just
plz	please
outa	out of
lookin	looking
nobodyy	nobody
deathh	death
b4	before
hv	have
noone	none
ily	i like you
ily2	i like you too
wats	whats
wbu	what about you
ive	i have
u	you
evn	even
ma	my
lil	little
gon	gonna
n	and
whateva	whatever
uni	university
cuz	because
w/o	without
bday	birthday
nd	and
im	i am
bc	because
thurdays	thursdays
thats	that's
untill	until
yall	you all
jus	just
wen	when
doin	doing
clinicals	clinical
cancled	cancelled
sleeeeeeep	sleep
tht	that
cnt	can't
msg	message
sh*tty	shitty
looooove	love
classss	class
typa	type of
aint	am not
darks	night	dark nights
tryna	trying to
schoolf	school
takin	taking
tumblr	tumbler
rting	rating
soo	so
idk	i don't know
its's	it's
bt	but
gud	good
luuuuuuv	love
givin	giving
theres	there is
rn	right now
jk	joking
foolin	fooling
wknd	weekend
nite	night
bdw	by the way
pls	please
u	you
kno	know
dat	that
lil	little
amazin	amazing
ur	you are
callng	calling
uv	you have
ment	meant
bcz	because
bcm	become
2morrow	tomorrow
gress	grace
4rm	from
bout	about
b	be
dnt	don't
wut	what
u	you
playin	playing
wendsday	wednesday
wendy's	wednesday's
wat	what
tuff	tough
dynamc	dynamic
thanx	thanks
belive	believe
todaaaay	today
hatin	hating
juss	just
hav	have
ladt	last
theyre	they're
reyt	right
dunt	dont
cos	because
slep	sleep
bein	being
tmrw	tomorrow
poppin	popping
txts	texts
heavenn	heaven
bball	ball
plesure	pleasure
stoes	stores
lyf	life
naebody	nobody
happend	happened
yoyos	yoyo
meself	myself
realy	really
tf	the fuck
wtf	what the fuck
wich	which
evenin	evening
mucchh	much
gunna	gonna
cecause	because
txt	text
nt	not
ugli	ugly
tonite	tonight
besties	best friends
w	with
bffs	best friends forever
htta	that
wil	will
gurl	girl
bcuz	because
ima	i am going to
whch	which
instlmnts	installments
acc	account
surrprise	surprise
allat	all at
shoulda	should have
inbetween	in between
slapen	dreamt
shittin	shitting
outcheaa	outreach
keel	kill
politly	politely
smaked	smacked
bt	but
wrds	words
perfer	prefer
foolin	fooling
awespme	awesome
iont	i won't
wid	with
phootshoot	photoshoot
babyy	baby
byee	bye
occassionally	occasionally
believ	believe
eim	i am
compltely	completely
pple	people
poppin	popping
hve	have
tht	that
gettin	getting
hawt	hot
ginna	gonna
mattah	matter
rantin	ranting
efing	effing
droolin	drooling
todays	today's
imma	i am going to
yo	your
brb	will be right back
breakout	break out
gonna	going to
gotta	got to
wanna	want to
hafta	have to
2nd	second
tht	that
msgs	messages
fuckin	fucking
freakin	freaking
loong	long
streamyy	streamy
hott	hot
goodd	good
lovin	loving
hopin	hoping
yup	yes
yupp	yes
yepp	yes
yep	yes
yum	tasty
yummy	tasty
yummyy	tasty
4ever	forever
cl	call
preps	preparations
mom	mother
mum	mother
mommy	mother
mummy	mother
mumma	mother
mums	mothers
moms	mothers
mums	mothers
mommies	mothers
bby	baby
fav	favourite
pup	puppy
neztalgic	nostalgic
celeb	celebrity
evn	even
jokng	joking
nothin	nothing
thx	thanks
thnx	thanks
yea	yes
dawg	dog
gals	girls
v	versus
vs	versus
perf	perfect
perv	pervert
aug	august
plz	please
plzz	please
1d	one direction
absolut	absolute
probs	problems
godd	god
guud	good
gud	good
rdy	ready
til	till
isnt	isn't
doesnt	doesn't
loonngg	long
loong	long
hipters	hipsters
amazin	amazing
goodmoring	goodmorning
aldvez	alive
whifth	which
moring	morning
somethin	something
pattient	patient
whatta	what a
tatted	tattooed
bout	about
artis	artist
bday	birthday
ur	your
lif	life
beggin	begging
comin	coming
chrstmas	christmas
bc	because
thats	that's
hoody	hoodie
descrive	describe
bothh	both
wearin	wearing
happi	happy
happie	happy
untill	until
hav	have
soo	so
kno	know
bbeessttffrriieenndd	bestfriend
youre	you're
foreva	forever
awadd	award
hubbie	hubby
ive	i have
beeing	being
veichles	vehicles
boootyful	bootyful
havent	haven't
havin	having
dnt	don't
cnt	can't
pushin	pushing
clik	click
dis	this
yesrs	years
acct	account
fly'in	flying
commandor	commander 
beliebe	believe
honesltyy	honestly
eeeeverywhere	everywhere
wouldnt	wouldn't
tru	true
wit	with
screaing	screaming
yeeass	yes
leakin	leaking
est	east
cudnt	couldn't
responsibily	responsibility
throughly	thoroughly
nest	next
lmfaoo	lmao
ima	i'm
trafic	traffic
gunna	gonna
disscution	discussion
disrespectin	disrespecting
id	i would
layed	laid
iont	i will not
whe	when
aint	ain't
stronkk	strong
youu	you
likk	like
don	don't
condifent	confident
didnt	didn't
wouldnt	wouldn't
doesnt	doesn't
wasnt	wasn't
kompletely	completely
significan't	significant
plannin	planning
looll	lol 
hatee	hate
dreds	dreads
couse	course
did'nt	didn't
jst	just
haate	hate
nuthin	nothing
shouldnt	shouldn't
hatee	hate
commited	committed
realty	reality
sincerly	sincerely
stoopp	stop
talkin	talking
abt	about
rhat	that
whats	what's
shamking	shaking
hamds	hands
makrs	makes
gooing	going
lieing	lying
juss	just
ally	allmy
nxt	next
hes	he's
goin	going
everytimy	everytime
youu	you
sleepin	sleeping
thearte	theater
skippin	skipping
suddenlt	suddenly
incrible	incredible
agressively	aggressively
aftr	after
frends	friends
boutta	aboutto
feally	really
tommorrow	tomorrow
becuz	because
tmrw	tomorrow
mucj	much
anf	and
ahe	she
ise	use
brixit	brexit
preperation	preparation
surveilance	surveillance
frands	friends
personaly	personally 
dowwnn	down
sloww	slow
ppl	people
nutela	nutella
photograh	photograph
simiulator	simulator
tyed	tied
whateva	whatever
flowin	flowing
gophs	gophers
themsleves	themselves
timez	times
theyre	they're
mdconald's	mcdonald's 
problemss	problems
mann	man
flu'd	fluid
gulitine	guillostine
walkin	walking
doctora	doctor
halding	holding
thezstreet	the street 
goin	going
nothingg	nothing
suuper	super
cutee	cute
youll	you'll
pratically	practically
theyd	they'd
thingzz	things
arent	aren't
hoties	hotties
thru	through
beautifull	beautiful
halarious	hilarious
reaally	really
especiall	especially
cna	can
bluddy	bloody
askewed	skewed
cple	couple
nawt	not
stayin	staying
shearts	seats
turonies	turnois
soo	so
laughrd	laughed
getto	ghetto
wkend	weekend
outfit	outflit
thid	thiss
tomrroww	tomorrow
thxgiving	thanksgiving
secreaming	screaming
wth	with
recieved	received
anymorem	anymore
reeally	really
borink	boring
paralel	parallel
pls	please
todaay	today
yearnin	yearning
learnin	learning
schooll	school
laugjing	laughing
